{
"level": [
  "GGGGGGGGGGGGGGGGG00000000000000000000000000000000000000000000000000000000000000000GGGGGGGGGGGGGGGGG",
  "GGG000000000000000",
  "00000000000000000G000000000000000000000000000000000000000000000000000000000000G",
  "000000000000000000000000000000000000000000000000000000000000000000000000000000G",
  "000000000000000000000000000000000000000000000000000000000000000000000000000000G",
  "000000000000000000000000000000000000000000000000000000000000000000000000000000G",
  "000000000000000000000000000000000000000000000000000000000000000000000000000000G",
  "000000000000000000000000000000000000000000000000000000000000000000000000000000G",
  "000000000000000000G00000000000000000000000GGGGGGGGGGGGGGGGGGG00000000000000000G",
  "000000000000000000000000000000000000000000000000000000000000000000000000000000G",
  "000000000000000000000000000000000000000000000000000000000000000000000000000GGGG",
  "0000000000000000000000000000000000000000000000000000000000000000000000000000000",
  "0000000000000000000000000000000000000000000000000000000000000000000000000000000",
  "0000000000000000000000000000000000000000000000000000000000000000000000000000000",
  "0000000000000000000000000000000000000000000000000000000000000000000000000000000",
  "0000000000000000000000000000000000000000000000000000000000000000000000000000000",
  "0000000000000000000000000000000000000000000000000000000000000000000000000000000",
  "0000000000000000000000000000000000000000000000000000000000000000000000000000000",
  "0000000000000000000000000000000000000000000000000000000000000000000000000000000",
  "GGGGGGGGGGGG0000000000000000000000000000000000000000000000000000000000000000000"

]
}