{
"level": [
  "GGGGGGGGGGGGGGGGG00000000000000000000000000000000000000000000000000000000000000000G00000000000000000000",
  "GGG000000000000000",
  "00000000000000000G0000000000000000000000000000000000000000000000000000000000000",
  "0000000000000000000000000000000000000000000000000000000000000000000000000000000",
  "0000000000000000000000000000000000000000000000000000000000000000000000000000000",
  "0000000000000000000000000000000000000000000000000000000000000000000000000000000",
  "0000000000000000000000000000000000000000000000000000000000000000000000000000000",
  "0000000000000000000000000000000000000000000000000000000000000000000000000000000",
  "000000000000000000G000000000000000000000000000000000000000000000000000000000000",
  "0000000000000000000000000000000000000000000000000000000000000000000000000000000",
  "0000000000000000000000000000000000000000000000000000000000000000000000000000000",
  "0000000000000000000000000000000000000000000000000000000000000000000000000000000",
  "0000000000000000000000000000000000000000000000000000000000000000000000000000000",
  "0000000000000000000000000000000000000000000000000000000000000000000000000000000",
  "0000000000000000000000000000000000000000000000000000000000000000000000000000000",
  "0000000000000000000000000000000000000000000000000000000000000000000000000000000",
  "0000000000000000000000000000000000000000000000000000000000000000000000000000000",
  "0000000000000000000000000000000000000000000000000000000000000000000000000000000",
  "0000000000000000000000000000000000000000000000000000000000000000000000000000000",
  "0000000000000000000000000000000000000000000000000000000000000000000000000000000",
  "GGGG000000000000000000000000000000000000000000000000000000000000000000000000000"
]
}